-- Hoogle documentation, generated by Haddock
-- See Hoogle, http://www.haskell.org/hoogle/


-- | Haskell binding to libharu (http://libharu.sourceforge.net/)
--   
--   Haskell binding to libharu (http:<i></i>libharu.sourceforge.net/)
@package HsHaruPDF
@version 0.0.0

module Graphics.PDF.Haru
data HPDF_Doc
type Doc = Ptr HPDF_Doc
data HPDF_Page
type Page = Ptr HPDF_Page
data HPDF_FontDef
type FontDef = Ptr HPDF_FontDef
type BOOL = CInt
_HPDF_FALSE :: BOOL
_HPDF_TRUE :: BOOL
withDoc :: String -> (Doc -> IO a) -> IO a
withPage :: Doc -> (Page -> IO a) -> IO a
text :: Page -> X -> Y -> FontDef -> Size -> String -> IO ()
type FontName = String
type X = CFloat
type Y = CFloat
type Size = CFloat
loadFontEmbedded :: Doc -> String -> IO FontDef
newDoc :: FunPtr HPDF_Error_Handler -> Ptr () -> IO Doc
addPage :: Doc -> IO Page
loadTTFontFromFile :: Doc -> CString -> BOOL -> IO CString
getFont :: Doc -> CString -> CString -> IO FontDef
beginText :: Page -> IO ()
endText :: Page -> IO ()
freeDoc :: Doc -> IO ()
saveToFile :: Doc -> CString -> IO ()
showText :: Page -> CString -> IO ()
setFontAndSize :: Page -> FontDef -> CFloat -> IO ()
setWidth :: Page -> X -> IO ()
setHeight :: Page -> Y -> IO ()
moveTextPos :: Page -> X -> Y -> IO ()
type HPDF_Error_Handler = CULong -> CULong -> Ptr () -> IO ()
errorHandler :: HPDF_Error_Handler
mkErrorHandlerCallback :: HPDF_Error_Handler -> IO (FunPtr HPDF_Error_Handler)
