-- Hoogle documentation, generated by Haddock
-- See Hoogle, http://www.haskell.org/hoogle/


-- | Companion tools for use with the GenI surface realiser
--   
@package geni-util
@version 0.24.1.1

module NLP.GenI.Report

-- | Return the output directory (might be a tmpdir)
createReport :: FilePath -> FilePath -> IO FilePath
readResults :: FilePath -> IO (Maybe Section)
isTestCaseDir :: FilePath -> IO Bool
data Result
Result :: Text -> SemInput -> [Text] -> [Text] -> [GeniResult] -> Result
reKey :: Result -> Text
reSemInput :: Result -> SemInput
reRealisations :: Result -> [Text]
reWarnings :: Result -> [Text]
reDerivation :: Result -> [GeniResult]
type Section = (FilePath, [Result])
mkReport :: Html -> Html -> ([Result] -> Html) -> [Section] -> Html
overviewTable :: [Section] -> Html
overviewRow :: Section -> Html
mkSummary :: [Section] -> Html
summaryTable :: [Result] -> Html
summaryRow :: Result -> Html
status :: Result -> AttributeValue
mkDetailsSummary :: [Section] -> Html
detailsTable :: [Result] -> Html
detailsRow :: Result -> Html
semInputToHtml :: SemInput -> Html
prettyKey :: Text -> Html
expandCount :: Text -> [Text]
unlinesCountHtml :: [Text] -> Html
dataFiles :: [FilePath]
lcSort :: [Text] -> [Text]
readFileIfExists :: a -> (Text -> a) -> FilePath -> IO a
readFileUtf8 :: FilePath -> IO Text
groupAndCount :: (Eq a, Ord a) => [a] -> [(a, Int)]
dropPrefix :: Eq a => [a] -> [a] -> ([a], [a])
getRealDirectoryContents :: FilePath -> IO [String]
instance ToMarkup (Literal GeniVal)

module NLP.GenI.Client
realise :: ByteString -> Word16 -> [String] -> Text -> IO (Result GeniResults)
