-- Hoogle documentation, generated by Haddock
-- See Hoogle, http://www.haskell.org/hoogle/


-- | File change watching utility
--   
@package watchit
@version 0.1.0.0


module WatchIt.Types
data Config
Config :: FilePath -> (FilePath -> Bool) -> (FilePath -> IO ()) -> Bool -> Int -> Bool -> Config
configPath :: Config -> FilePath
configFilter :: Config -> FilePath -> Bool
configAction :: Config -> FilePath -> IO ()
configForce :: Config -> Bool
configNumJobs :: Config -> Int
configRecur :: Config -> Bool
defaultConfig :: Config


module WatchIt.Options
data Options
Options :: Maybe String -> Maybe String -> Maybe Bool -> Maybe Int -> Maybe Bool -> Maybe String -> Options
optionsPath :: Options -> Maybe String
optionsExt :: Options -> Maybe String
optionsForce :: Options -> Maybe Bool
optionsNumJobs :: Options -> Maybe Int
optionsNotRec :: Options -> Maybe Bool
optionsCmd :: Options -> Maybe String
defaultOptions :: Options
parseOptions :: Parser Options
infoOptions :: ParserInfo Options
instance Eq Options
instance Show Options


module WatchIt
defaultMain :: IO ()
watchIt :: Config -> IO ()
